20 25
100 800
0 0 0 0 0 0 0 0 0 0 0 0 0 0 0 0 0 0 0 0
0 0 0 0 0 0 0 0 0 0 0 0 0 0 0 0 0 0 0 0
0 0 0 0 0 0 0 0 0 0 0 0 0 0 0 0 0 0 0 0
0 0 0 0 0 0 0 0 0 0 0 0 0 0 0 0 0 0 0 0
0 0 0 0 0 0 0 0 0 0 0 0 0 0 0 0 0 0 0 0
0 0 0 0 0 0 0 0 0 0 0 0 0 0 0 0 0 0 0 0
2 0 0 0 0 0 0 0 0 0 0 0 0 0 0 0 0 0 0 2
5 0 0 0 0 0 0 0 0 0 0 0 0 0 0 0 0 0 2 5
5 0 0 0 0 0 0 0 0 0 0 0 0 0 0 0 0 2 5 5
5 0 0 0 0 0 0 0 0 0 0 0 0 0 0 0 2 5 5 5
9 0 0 0 0 0 0 0 0 0 0 0 0 0 0 2 5 5 5 5
0 0 0 0 0 0 0 0 0 0 0 0 0 0 2 5 5 5 5 5
0 0 0 0 0 0 0 0 0 0 0 0 0 2 5 5 5 5 5 5
2 2 2 2 2 2 0 2 2 2 2 2 2 5 5 5 5 5 5 5
5 5 5 5 5 5 0 5 5 5 5 5 5 5 5 5 5 5 5 5
9 9 9 9 9 9 0 9 9 9 9 9 9 9 9 9 9 9 9 9
0 0 0 0 0 0 0 0 0 0 0 0 0 0 0 0 0 0 0 0
0 0 0 0 0 0 0 0 0 0 0 0 0 0 0 0 0 0 0 0
0 0 0 0 0 0 0 0 0 0 0 0 0 0 0 0 0 0 0 0
0 0 0 0 0 0 0 0 0 0 0 0 0 0 0 0 0 0 0 0
0 0 0 0 0 0 0 0 0 0 0 0 0 0 0 0 0 0 0 0
0 0 0 0 0 0 0 0 0 0 0 0 0 0 0 0 0 0 0 0
0 0 0 0 0 0 0 0 0 0 0 0 0 0 0 0 0 0 0 0
0 0 0 0 0 0 0 0 0 0 0 0 0 0 0 0 0 0 0 0
0 0 0 0 0 0 0 0 0 0 0 0 0 0 0 0 0 0 0 0